1111111111111111
10000000000C0001
10000C000000C001
1000000C00000001
10001111000C0001
100000000C00C001
100C0000000C0001
1000000C01000001
10000000000C0001
10000000000C0001
1E000000000C0001
1P000000000C0001
1111111111111111
