1111111111
1000000001
10E1010001
1111110111
1001000101
1001C00101
1000000001
1111110111
10C1000101
10000C0101
1001000001
1011111101
1000010101
1001010101
1011000101
1001010101
1111110111
1P00000001
1000100101
1111111111
