11111111111
1E1C00C0001
10111111101
1000CC00101
11111110101
1C0C001C0C1
1C111111101
10100000001
10101111111
10000C00P01
11111111111