11111111111
1E00C0000C1
11111111101
1C0000100C1
10111010111
1010001P0C1
10111111101
1CC00C1C001
10111010111
10001C00001
11111111111