11111111111
1E100000001
1P111011101
100C00101C1
1111111C1C1
100C1C00101
1011101C101
10C00010001
10111111111
1000C000001
11111111111