11111111
10000001
10000001
1000E001
10000001
1000C001
1P000001
11111111
